###########
#@...#....#
#....#....#
#....#....#
#....#....#
##.####.###
#....#....#
#....#....#
#....#....#
#.........#
###########